-1 -1 -1 -1 -1 -1 -1 -1 -1 -1 -1 -1 -1 -1 -1 0 1 2 3 -1 -1 -1 -1 -1 -1 -1 -1 -1 -1 -1 -1 -1 -1 -1 -1 -1 -1 -1
-1 -1 -1 -1 -1 -1 -1 -1 -1 -1 -1 -1 -1 -1 -1 20 21 22 23 -1 -1 -1 -1 -1 -1 -1 -1 -1 -1 -1 -1 -1 -1 -1 -1 -1 -1 -1
94 94 94 94 94 94 94 94 94 94 94 94 94 94 94 40 41 42 43 94 94 94 94 94 94 94 94 94 94 94 94 94 94 94 94 94 94 94
94 177 177 177 177 177 177 177 177 177 177 177 177 177 177 60 61 62 63 177 177 177 177 177 177 177 177 177 177 177 177 177 177 177 177 177 177 94
94 177 177 177 177 177 177 177 177 177 177 177 177 177 177 80 81 82 83 177 177 177 177 177 177 177 177 177 177 177 177 177 177 177 177 177 177 94
94 177 177 177 177 177 177 177 177 177 177 177 177 177 177 100 101 102 103 177 177 177 177 177 177 177 177 177 177 177 177 177 177 177 177 177 177 94
94 177 177 177 177 177 177 177 177 177 177 177 177 200 205 120 121 231 231 232 53 177 177 177 177 177 177 177 177 177 177 177 177 177 177 177 177 94
94 177 177 177 177 177 177 177 177 177 177 177 177 224 225 72 72 210 211 212 73 177 177 177 177 177 177 177 177 177 177 177 177 177 177 177 177 94
94 177 177 177 177 177 177 177 177 177 177 200 201 91 92 92 92 92 92 92 93 204 205 177 177 177 177 177 177 177 177 177 177 177 177 177 177 94
94 177 177 177 177 177 177 177 177 177 177 220 221 200 202 202 202 202 202 202 205 224 225 177 177 177 177 177 177 177 177 177 177 177 177 177 177 94
94 177 177 177 177 177 177 177 177 177 94 177 177 220 223 224 223 224 224 224 225 177 177 177 177 94 177 94 177 177 177 177 177 177 177 177 177 94
94 177 177 177 177 177 177 177 177 177 177 51 52 52 52 52 52 52 52 52 52 52 52 52 52 52 53 177 177 177 177 177 177 177 177 177 177 94
94 177 177 177 177 177 177 177 177 177 94 71 94 72 72 72 72 72 72 72 72 72 72 72 72 94 73 94 177 177 177 177 177 177 177 177 177 94
94 177 177 177 177 177 177 177 177 177 177 71 72 72 72 72 72 72 72 72 72 72 72 72 72 72 73 177 177 177 177 177 177 177 177 177 177 94
94 177 177 177 177 177 177 177 177 177 177 71 72 72 72 72 72 72 72 72 72 72 72 72 72 72 73 177 177 177 177 177 177 177 177 177 177 94
94 177 177 177 177 177 177 177 177 177 177 71 72 72 72 72 72 72 72 72 72 72 72 72 72 72 73 177 177 177 177 177 177 177 177 177 177 94
94 177 177 177 177 177 177 177 177 177 94 71 72 72 72 72 72 72 72 72 72 72 72 72 72 72 73 94 177 177 177 177 177 177 177 177 177 94
94 177 177 177 177 177 177 177 177 177 94 71 72 72 72 72 72 72 72 72 72 72 72 72 72 72 73 94 177 177 177 177 177 177 177 177 177 94
94 177 177 177 177 177 177 177 177 177 94 71 72 72 72 72 72 72 72 72 72 72 72 72 72 72 73 94 177 177 177 177 177 177 177 177 177 94
94 177 177 177 177 177 177 177 177 177 177 71 72 72 72 72 72 72 72 72 72 72 72 72 72 72 73 177 177 177 177 177 177 177 177 177 177 94
94 177 177 177 177 177 177 177 177 177 177 71 72 72 72 72 72 72 72 72 72 72 72 72 72 72 73 177 177 177 177 177 177 177 177 177 177 94
94 177 177 177 177 177 177 177 177 177 177 71 72 72 72 72 72 72 72 72 72 72 72 72 72 72 73 177 177 177 177 177 177 177 177 177 177 94
94 177 177 177 177 177 177 177 177 177 94 71 94 72 72 72 72 72 72 72 72 72 72 72 72 94 73 94 177 177 177 177 177 177 177 177 177 94
94 177 177 177 177 177 177 177 177 177 177 91 92 92 92 92 92 92 92 92 92 92 92 92 92 92 93 177 177 177 177 177 177 177 177 177 177 94
94 177 177 177 177 177 177 177 177 177 94 177 94 177 177 177 177 177 94 94 177 177 177 177 177 94 177 94 177 177 177 177 177 177 177 177 177 94
94 177 177 177 177 177 177 177 177 177 177 177 177 177 177 177 177 177 177 177 177 177 177 177 177 177 177 177 177 177 177 177 177 177 177 177 177 94
94 177 177 177 177 177 177 177 177 177 177 177 177 177 177 177 177 177 177 177 177 177 177 177 177 177 177 177 177 177 177 177 177 177 177 177 177 94
94 177 177 177 177 177 177 177 177 177 177 177 177 177 177 177 177 177 177 177 177 177 177 177 177 177 177 177 177 177 177 177 177 177 177 177 177 94
94 177 177 177 177 177 177 177 177 177 177 177 177 177 177 177 177 177 177 177 177 177 177 177 177 177 177 177 177 177 177 177 177 177 177 177 177 94
94 177 177 177 177 177 177 177 177 177 177 177 177 177 177 177 177 177 177 177 177 177 177 177 177 177 177 177 177 177 177 177 177 177 177 177 177 94
94 177 177 177 177 177 177 177 177 177 177 177 177 177 177 177 177 177 177 177 177 177 177 177 177 177 177 177 177 177 177 177 177 177 177 177 177 94
94 177 177 177 177 177 177 177 177 177 177 177 177 177 177 177 177 177 177 177 177 177 177 177 177 177 177 177 177 177 177 177 177 177 177 177 177 94
94 94 94 94 94 94 94 94 94 94 94 94 94 94 94 94 94 94 94 94 94 94 94 94 94 94 94 94 94 94 94 94 94 94 94 94 94 94