-1 -1 -1 -1 -1 -1 -1 -1 -1 -1 -1 -1 -1 -1 116 116 116 116 116 116 116 116 116 116 116 116 116 116 116 116 -1 -1 -1 -1 -1 -1 -1 -1 -1 -1 -1 -1 -1
-1 -1 -1 -1 -1 -1 -1 -1 -1 -1 -1 -1 -1 116 116 116 116 116 116 116 116 116 116 116 116 116 116 116 116 116 -1 -1 -1 -1 -1 -1 -1 -1 -1 -1 -1 -1 -1
44 44 44 44 44 44 44 44 44 145 44 44 44 116 116 116 116 116 116 116 116 116 116 116 116 116 116 116 116 116 -1 -1 -1 -1 -1 -1 -1 -1 -1 -1 -1 -1 -1
44 44 44 4 44 125 44 4 44 44 44 4 44 116 116 116 116 116 116 94 131 131 131 94 116 116 116 116 116 116 -1 -1 -1 -1 -1 -1 -1 -1 -1 -1 -1 -1 -1
144 144 144 24 144 144 144 24 144 144 144 24 144 144 112 116 116 116 116 109 48 49 50 108 116 116 116 116 116 116 -1 -1 -1 -1 -1 -1 -1 -1 -1 -1 -1 -1 -1
144 48 49 49 49 49 49 49 49 49 49 49 50 144 112 116 116 116 116 109 68 69 70 108 116 116 116 116 116 116 -1 -1 -1 -1 -1 -1 -1 -1 -1 -1 -1 -1 -1
144 68 69 69 84 69 69 69 69 69 69 69 8 144 112 125 116 116 116 109 68 69 70 108 116 116 116 116 116 116 -1 -1 -1 -1 -1 -1 -1 -1 -1 -1 -1 -1 -1
144 68 69 69 69 69 69 69 69 69 84 69 8 144 112 116 116 116 116 109 68 69 70 108 116 116 116 116 116 116 116 -1 -1 -1 -1 -1 -1 -1 -1 -1 -1 -1 -1
144 68 69 69 69 69 69 84 200 202 205 69 8 144 112 116 116 116 116 113 68 69 70 108 116 116 116 116 116 116 116 116 116 116 116 116 116 116 116 116 116 116 -1
144 68 69 84 69 69 69 69 120 123 124 69 8 144 112 116 116 116 116 109 68 69 70 108 116 116 116 116 116 116 116 116 116 116 116 116 116 116 116 116 116 116 116
144 68 69 69 69 69 69 69 69 69 84 69 8 144 112 116 116 145 116 109 68 69 70 108 116 116 116 116 116 116 116 116 116 116 116 116 116 116 116 116 116 116 116
144 68 69 69 69 69 69 69 69 69 69 69 8 144 112 116 116 116 116 109 68 69 70 108 116 116 116 116 116 116 116 116 116 116 116 116 116 116 116 116 116 116 116
144 68 69 69 69 69 69 69 69 69 69 69 8 144 112 145 116 116 116 109 68 69 70 108 116 116 116 116 116 116 116 116 116 116 116 116 116 116 116 116 116 116 116
144 68 200 201 201 201 205 69 69 47 69 69 8 144 112 116 116 116 116 109 68 69 70 108 116 116 116 116 116 116 116 116 116 116 116 116 116 116 116 116 116 116 116
144 68 220 221 222 223 224 69 69 69 69 47 8 143 134 134 134 134 134 127 68 69 70 108 116 116 116 116 116 116 116 116 116 116 116 116 116 116 116 116 116 116 116
144 68 47 69 69 47 69 69 69 69 69 69 47 66 66 66 66 66 66 66 84 69 70 108 116 116 116 116 116 116 116 116 116 116 116 116 116 116 116 116 116 116 116
144 88 89 89 89 89 89 89 89 65 89 89 90 143 114 114 114 114 114 97 68 69 70 108 116 116 116 116 116 116 116 116 116 116 116 116 116 116 116 116 116 116 116
144 144 144 144 144 144 143 143 143 85 143 143 143 143 116 116 116 116 116 117 68 69 70 135 136 136 136 136 136 136 136 136 136 136 136 156 156 156 156 156 116 116 116
-1 -1 -1 -1 -1 -1 -1 -1 109 85 108 116 116 116 116 116 116 116 116 117 68 69 47 49 49 49 49 49 49 49 49 49 49 49 49 69 69 69 69 69 116 -1 -1
-1 -1 -1 -1 -1 -1 -1 -1 109 85 108 116 116 116 116 150 151 152 116 117 88 89 89 89 89 89 89 89 89 89 89 89 89 89 89 89 89 69 69 69 -1 -1 -1
-1 -1 -1 -1 -1 -1 -1 -1 109 85 108 116 116 116 116 170 171 172 116 125 111 86 96 146 146 96 96 146 146 96 96 146 146 96 96 146 146 -1 -1 -1 -1 -1 -1
-1 -1 -1 -1 -1 -1 94 136 137 85 135 94 94 134 134 190 191 192 134 134 134 94 -1 -1 -1 -1 -1 -1 -1 -1 -1 -1 -1 -1 -1 -1 -1 -1 -1 -1 -1 -1 -1
-1 -1 -1 -1 -1 -1 113 116 116 65 116 94 116 116 229 210 211 212 249 116 116 115 -1 -1 -1 -1 -1 -1 -1 -1 -1 -1 -1 -1 -1 -1 -1 -1 -1 -1 -1 -1 -1
-1 -1 -1 -1 -1 -1 117 48 49 69 70 94 116 116 116 116 116 116 116 116 116 115 -1 -1 -1 -1 -1 -1 -1 -1 -1 -1 -1 -1 -1 -1 -1 -1 -1 -1 -1 -1 -1
-1 -1 -1 -1 -1 -1 117 68 69 69 47 116 116 116 116 116 116 116 116 116 116 115 -1 -1 -1 -1 -1 -1 -1 -1 -1 -1 -1 -1 -1 -1 -1 -1 -1 -1 -1 -1 -1
-1 -1 -1 -1 -1 -1 117 94 69 69 69 116 116 116 94 49 49 49 94 116 116 115 -1 -1 -1 -1 -1 -1 -1 -1 -1 -1 -1 -1 -1 -1 -1 -1 -1 -1 -1 -1 -1
-1 -1 -1 -1 -1 -1 117 94 89 89 89 116 116 116 68 69 69 69 70 116 116 115 -1 -1 -1 -1 -1 -1 -1 -1 -1 -1 -1 -1 -1 -1 -1 -1 -1 -1 -1 -1 -1
-1 -1 -1 -1 -1 -1 94 94 96 96 96 97 116 116 68 69 69 69 70 116 116 115 -1 -1 -1 -1 -1 -1 -1 -1 -1 -1 -1 -1 -1 -1 -1 -1 -1 -1 -1 -1 -1
-1 -1 -1 -1 -1 -1 -1 -1 -1 -1 -1 109 116 116 68 69 69 69 70 116 116 115 -1 -1 -1 -1 -1 -1 -1 -1 -1 -1 -1 -1 -1 -1 -1 -1 -1 -1 -1 -1 -1
-1 -1 -1 -1 -1 -1 -1 -1 -1 -1 -1 109 116 116 94 89 89 89 94 116 116 115 -1 -1 -1 -1 -1 -1 -1 -1 -1 -1 -1 -1 -1 -1 -1 -1 -1 -1 -1 -1 -1
-1 -1 -1 -1 -1 -1 -1 -1 -1 -1 -1 109 116 116 116 116 116 116 116 116 116 115 -1 -1 -1 -1 -1 -1 -1 -1 -1 -1 -1 -1 -1 -1 -1 -1 -1 -1 -1 -1 -1
-1 -1 -1 -1 -1 -1 -1 -1 -1 -1 -1 94 96 96 96 96 96 96 96 96 96 94 -1 -1 -1 -1 -1 -1 -1 -1 -1 -1 -1 -1 -1 -1 -1 -1 -1 -1 -1 -1 -1
