-1 -1 -1 -1 -1 -1 -1 -1 -1 -1 -1 -1 -1 -1 48 49 50
-1 -1 -1 -1 -1 -1 -1 -1 -1 -1 -1 -1 -1 -1 68 69 70
-1 -1 -1 -1 -1 -1 -1 -1 -1 -1 -1 -1 -1 -1 68 69 70
-1 -1 -1 -1 -1 -1 -1 -1 -1 -1 -1 -1 -1 -1 68 69 70
-1 -1 -1 -1 -1 -1 -1 -1 -1 -1 -1 -1 -1 -1 68 69 70
-1 -1 -1 -1 -1 -1 -1 -1 -1 -1 -1 -1 -1 -1 68 69 70
-1 -1 -1 -1 -1 -1 -1 -1 -1 -1 -1 -1 -1 -1 68 69 70
-1 -1 4 -1 4 -1 -1 -1 -1 -1 -1 -1 -1 -1 68 69 70
-1 143 24 143 24 143 143 -1 -1 -1 -1 -1 -1 -1 68 69 70
143 143 48 49 49 50 143 -1 -1 -1 -1 -1 -1 -1 68 69 70
143 48 69 69 69 47 50 143 -1 -1 -1 -1 -1 -1 68 69 70
143 68 69 69 69 69 47 66 66 66 66 66 66 66 84 69 70
143 88 89 65 89 89 90 143 -1 -1 -1 -1 -1 -1 68 69 70
143 143 143 85 143 143 143 143 -1 -1 -1 -1 -1 -1 68 69 70
-1 -1 -1 85 -1 -1 -1 -1 -1 -1 -1 -1 -1 -1 68 69 70
-1 -1 -1 85 -1 -1 -1 -1 -1 150 151 152 -1 -1 88 -1 -1
-1 -1 -1 85 -1 -1 -1 -1 -1 170 171 172 -1 -1 -1 -1 -1
-1 -1 -1 85 -1 -1 -1 -1 -1 190 191 192 -1 -1 -1 -1 -1
-1 -1 48 65 50 -1 95 96 229 210 211 212 249 96 97 -1 -1
-1 -1 68 69 70 -1 108 116 116 116 116 116 116 116 117 -1 -1
-1 -1 68 69 47 49 49 116 116 116 116 116 116 116 117 -1 -1
-1 -1 68 69 69 69 69 116 116 116 116 116 116 116 117 -1 -1
-1 -1 88 89 89 89 89 116 116 116 116 116 116 116 117 -1 -1
-1 -1 -1 -1 -1 -1 -1 112 116 116 116 116 116 116 117 -1 -1
-1 -1 -1 -1 -1 -1 -1 147 116 116 116 116 116 116 117 -1 -1
-1 -1 -1 -1 -1 -1 -1 147 116 116 116 116 116 116 117 -1 -1
-1 -1 -1 -1 -1 -1 -1 126 136 136 136 136 136 136 137 -1 -1
