-1 -1 -1 -1 -1 -1 -1 -1 -1 -1 -1 -1 -1 -1 -1 -1 -1 116 116 116 116 116 116 116 116 116 116 116 116 116 116 116 116 116 116 116 116 136 136 136 136 136 136 136 136 136 136 136 136 136 136 136 136 -1 -1 -1 -1 -1 -1 -1 -1 -1 -1 -1 -1 -1 -1 -1 -1 -1 -1 -1 -1 -1 -1 -1 -1 -1 -1 -1
-1 -1 -1 -1 -1 -1 -1 -1 -1 -1 -1 -1 -1 -1 -1 -1 -1 116 116 116 116 116 116 116 116 116 116 116 116 116 116 116 116 116 116 116 116 96 96 96 96 96 96 96 96 96 96 96 96 96 96 96 96 -1 -1 -1 -1 -1 -1 -1 -1 -1 -1 -1 -1 -1 -1 -1 -1 -1 -1 -1 -1 -1 -1 -1 -1 -1 -1 -1
-1 -1 -1 -1 -1 -1 -1 -1 -1 -1 -1 -1 -1 -1 -1 -1 -1 116 116 116 116 116 116 116 116 116 116 116 116 116 116 116 116 116 116 116 116 -1 -1 -1 -1 -1 -1 -1 -1 -1 -1 -1 -1 -1 -1 -1 -1 -1 -1 -1 -1 -1 -1 -1 -1 -1 -1 -1 -1 -1 -1 -1 -1 -1 -1 -1 -1 -1 -1 -1 -1 -1 -1 -1
-1 -1 -1 -1 -1 -1 -1 -1 -1 -1 -1 -1 -1 -1 -1 -1 -1 116 116 116 116 116 116 116 116 116 116 116 116 116 116 116 116 116 116 116 116 -1 -1 -1 -1 -1 -1 -1 -1 -1 -1 -1 -1 -1 -1 -1 -1 -1 -1 -1 -1 -1 -1 -1 -1 -1 -1 -1 -1 -1 -1 -1 -1 -1 -1 -1 -1 -1 -1 -1 -1 -1 -1 -1
-1 -1 -1 -1 -1 -1 -1 -1 -1 -1 -1 -1 -1 -1 -1 -1 -1 116 116 116 116 116 116 116 116 116 116 116 116 116 116 116 116 116 116 116 116 -1 -1 -1 -1 -1 -1 -1 -1 -1 -1 -1 -1 -1 -1 -1 -1 -1 -1 -1 -1 -1 -1 -1 -1 -1 -1 -1 -1 -1 -1 -1 -1 -1 -1 -1 -1 -1 -1 -1 -1 -1 -1 -1
-1 -1 -1 -1 -1 -1 -1 -1 -1 -1 -1 -1 -1 -1 -1 -1 -1 116 116 116 116 116 116 116 116 116 116 116 116 116 116 116 116 116 116 116 116 -1 -1 -1 -1 -1 -1 -1 -1 -1 -1 -1 -1 -1 -1 -1 -1 -1 -1 -1 -1 -1 -1 -1 -1 -1 -1 -1 -1 -1 -1 -1 -1 -1 -1 -1 -1 -1 -1 -1 -1 -1 -1 -1
-1 -1 -1 -1 -1 -1 -1 -1 -1 -1 -1 -1 -1 -1 -1 -1 -1 116 116 116 116 116 116 116 116 116 116 116 116 116 116 116 116 116 116 116 116 -1 -1 -1 -1 -1 -1 -1 -1 -1 -1 -1 -1 -1 -1 -1 -1 -1 -1 -1 -1 -1 -1 -1 -1 -1 -1 -1 -1 -1 -1 -1 -1 -1 -1 -1 -1 -1 -1 -1 -1 -1 -1 -1
-1 -1 -1 -1 -1 -1 -1 -1 -1 -1 -1 -1 -1 -1 -1 -1 -1 116 116 116 116 116 116 116 116 116 143 143 143 143 143 143 143 143 143 143 143 143 143 143 143 143 143 143 143 143 -1 -1 -1 -1 -1 -1 -1 -1 -1 -1 -1 -1 -1 -1 -1 -1 -1 -1 -1 -1 -1 -1 -1 -1 -1 -1 -1 -1 -1 -1 -1 -1 -1 -1
-1 -1 -1 -1 -1 -1 -1 -1 -1 -1 -1 -1 -1 -1 -1 -1 -1 116 116 116 116 116 116 116 116 116 143 48 49 49 49 49 49 49 49 49 49 49 49 49 49 49 49 49 50 143 -1 -1 -1 -1 -1 -1 -1 -1 -1 -1 -1 -1 -1 -1 -1 -1 -1 -1 -1 -1 -1 -1 -1 -1 -1 -1 -1 -1 -1 -1 -1 -1 -1 -1
-1 -1 -1 -1 -1 -1 -1 -1 -1 -1 -1 -1 -1 -1 -1 -1 -1 116 116 116 116 116 116 116 116 116 143 68 69 69 69 69 69 69 69 69 69 69 69 69 69 200 201 69 70 143 -1 -1 -1 -1 -1 -1 -1 -1 -1 -1 -1 -1 -1 -1 -1 -1 -1 -1 -1 -1 -1 -1 -1 -1 -1 -1 -1 -1 -1 -1 -1 -1 -1 -1
-1 -1 -1 -1 -1 -1 -1 -1 -1 -1 -1 -1 -1 -1 -1 -1 -1 116 116 116 116 116 116 116 116 116 143 68 69 69 69 69 69 69 69 69 69 69 69 69 69 220 221 69 70 143 -1 -1 -1 -1 -1 116 116 116 116 116 116 116 116 116 116 116 116 116 116 116 116 -1 -1 -1 -1 -1 -1 -1 -1 -1 -1 -1 -1 -1
-1 -1 -1 -1 -1 -1 -1 -1 -1 -1 -1 -1 -1 -1 -1 -1 -1 116 116 116 116 116 116 116 116 116 143 68 69 69 69 69 69 69 69 69 69 69 69 69 69 45 69 69 70 143 -1 -1 -1 -1 116 116 116 116 116 116 116 116 116 116 116 116 116 116 116 116 116 -1 -1 -1 -1 -1 -1 -1 -1 -1 -1 -1 -1 -1
-1 -1 -1 -1 -1 -1 -1 -1 -1 -1 -1 -1 -1 -1 -1 -1 -1 116 116 116 116 116 116 116 116 116 143 68 69 69 69 69 69 69 69 69 69 69 69 69 69 85 69 69 70 143 145 44 44 44 116 116 116 116 116 116 116 116 116 116 116 116 116 116 116 116 116 -1 -1 -1 -1 -1 -1 -1 -1 -1 -1 -1 -1 -1
-1 -1 -1 -1 -1 -1 -1 -1 -1 -1 -1 -1 -1 -1 -1 -1 -1 116 116 116 116 116 116 116 116 116 143 68 69 69 69 69 69 203 204 69 69 69 69 69 69 85 69 69 70 143 44 44 4 44 116 116 116 116 116 116 94 131 131 131 94 116 116 116 116 116 116 -1 -1 -1 -1 -1 -1 -1 -1 -1 -1 -1 -1 -1
-1 -1 -1 -1 -1 -1 -1 -1 -1 -1 -1 -1 -1 -1 -1 -1 -1 116 116 116 116 116 116 116 116 116 143 68 69 69 69 69 69 223 224 69 69 69 69 69 69 85 69 69 70 104 142 144 24 144 144 112 116 116 116 116 109 48 49 50 108 116 116 116 116 116 116 -1 -1 -1 -1 -1 -1 -1 -1 -1 -1 -1 -1 -1
-1 -1 -1 -1 -1 -1 -1 -1 -1 -1 -1 -1 -1 -1 -1 -1 -1 116 116 116 116 116 116 116 116 116 143 68 69 69 69 69 69 45 69 69 69 69 69 69 69 85 69 69 69 49 49 49 49 50 144 112 116 116 116 116 109 68 69 70 108 116 116 116 116 116 116 -1 -1 -1 -1 -1 -1 -1 -1 -1 -1 -1 -1 -1
-1 -1 -1 -1 -1 -1 -1 -1 -1 -1 -1 -1 -1 -1 -1 -1 -1 116 116 116 116 116 116 116 116 116 143 68 69 69 45 69 69 85 69 69 69 69 69 69 69 85 69 69 69 69 69 69 69 8 144 112 125 116 116 116 109 68 69 70 108 116 116 116 116 116 116 -1 -1 -1 -1 -1 -1 -1 -1 -1 -1 -1 -1 -1
-1 -1 -1 -1 -1 -1 -1 -1 -1 -1 -1 -1 -1 -1 -1 -1 -1 116 116 116 116 116 116 116 116 116 143 68 69 64 65 66 66 65 66 66 66 66 66 66 66 65 67 69 69 69 69 84 69 8 144 112 116 116 116 116 109 68 69 70 108 116 116 116 116 116 116 116 -1 -1 -1 -1 -1 -1 -1 -1 -1 -1 -1 -1
-1 -1 -1 -1 -1 -1 -1 -1 -1 -1 -1 -1 -1 -1 -1 -1 -1 116 116 116 116 116 116 116 116 116 143 68 69 69 85 69 69 105 69 69 69 69 69 69 69 85 69 69 84 200 202 205 69 8 144 112 116 116 116 116 113 68 69 70 108 116 116 116 116 116 116 116 116 116 116 116 116 116 116 116 116 116 116 -1
-1 -1 -1 -1 -1 -1 -1 -1 -1 -1 -1 -1 -1 -1 -1 -1 -1 116 116 116 116 116 116 116 116 116 143 88 89 89 85 89 89 89 89 89 89 89 46 69 84 85 69 69 69 120 123 124 69 8 144 112 116 116 116 116 109 68 69 70 108 116 116 116 116 116 116 116 116 116 116 116 116 116 116 116 116 116 116 116
179 179 179 179 179 179 179 179 179 179 179 179 179 179 179 179 179 116 116 116 116 116 116 116 116 116 143 143 142 143 85 143 143 142 143 143 143 144 68 69 69 85 69 69 69 69 45 84 69 8 144 112 116 116 145 116 109 68 69 70 108 116 116 116 116 116 116 116 116 116 116 116 116 116 116 116 116 116 116 116
179 179 179 179 179 179 179 179 179 179 179 179 179 179 179 179 179 179 179 179 179 179 179 179 179 179 179 179 179 143 85 144 179 179 179 179 179 144 68 69 69 65 66 66 66 66 65 69 69 8 144 112 116 116 116 116 109 68 69 70 108 116 116 116 116 116 116 116 116 116 116 116 116 116 116 116 116 116 116 116
179 179 179 179 179 179 179 179 179 179 179 179 179 179 179 179 179 179 179 179 179 179 179 179 179 179 179 179 179 144 85 144 179 179 179 179 179 144 68 69 69 69 69 69 69 69 85 69 69 8 144 112 145 116 116 116 109 68 69 70 108 116 116 116 116 116 116 116 116 116 116 116 116 116 116 116 116 116 116 116
179 179 179 179 179 179 179 179 179 179 179 179 179 179 179 179 179 179 179 179 179 179 179 179 179 179 179 179 144 144 85 144 144 179 179 179 179 144 68 200 201 201 201 205 69 69 85 69 69 8 144 112 116 116 116 116 109 68 69 70 108 116 116 116 116 116 116 116 116 116 116 116 116 116 116 116 116 116 116 116
179 179 179 179 179 179 179 179 179 179 179 179 179 179 179 179 179 179 179 179 179 179 179 179 179 179 179 179 144 48 65 50 144 179 179 179 179 144 68 220 221 222 223 224 69 69 85 69 47 8 142 134 134 134 134 134 127 68 69 70 108 116 116 116 116 116 116 116 116 116 116 116 116 116 116 116 116 116 116 116
179 179 179 179 179 179 179 179 179 179 179 179 179 179 179 179 179 179 179 179 179 179 179 179 179 179 179 179 144 68 65 70 144 179 179 179 179 144 68 47 69 69 64 66 66 66 65 66 66 66 66 66 66 66 66 66 66 84 69 70 108 116 116 116 116 116 116 116 116 116 116 116 116 116 116 116 116 116 116 116
179 179 179 179 179 179 179 179 179 179 179 179 179 179 179 179 179 179 179 179 179 179 179 179 179 179 179 179 144 88 65 90 144 179 179 179 179 144 88 89 89 89 89 89 89 89 85 89 89 90 143 114 114 114 114 114 97 68 69 70 108 116 116 116 116 116 116 116 116 116 116 116 116 116 116 116 116 116 116 116
179 179 179 179 179 179 179 179 179 179 179 179 179 179 179 179 179 179 179 179 179 179 179 179 179 179 179 179 144 144 85 144 144 179 179 179 179 144 144 144 144 144 144 143 143 143 144 143 143 143 143 116 116 116 116 116 117 68 69 70 135 136 136 136 136 136 136 136 136 136 136 136 156 156 156 156 156 116 116 116
179 179 179 179 179 179 179 179 179 179 179 179 179 179 179 179 179 179 94 94 94 94 94 94 94 94 94 94 94 94 85 94 94 94 94 179 179 168 168 168 168 168 116 116 116 116 116 116 116 116 116 116 116 116 116 116 117 68 69 47 49 49 49 49 49 49 49 49 49 49 49 49 69 69 69 69 69 116 -1 -1
179 179 179 179 179 179 179 179 179 179 179 179 179 179 179 179 179 179 94 48 66 66 66 50 94 94 94 94 94 94 85 94 94 94 94 179 179 168 168 168 168 168 116 116 116 116 116 116 116 116 116 116 150 151 152 116 117 88 89 89 89 89 89 89 89 89 89 89 89 89 89 89 89 89 69 69 69 -1 -1 -1
179 179 179 179 179 179 179 179 179 179 179 179 179 179 179 179 179 94 94 85 94 94 94 85 94 48 66 50 94 94 85 94 94 94 94 179 179 168 168 168 168 168 116 116 116 116 116 116 116 116 116 116 170 171 172 116 125 111 86 96 146 146 96 96 89 146 96 96 146 146 96 96 146 146 -1 -1 -1 -1 -1 -1
179 179 179 179 179 179 179 179 179 179 179 179 179 179 179 179 179 94 48 65 49 67 94 88 66 90 94 88 66 66 65 66 66 50 94 179 179 94 94 94 168 168 116 94 94 94 94 94 94 94 94 94 190 191 192 94 94 94 94 -1 -1 -1 -1 -1 -1 -1 -1 -1 -1 -1 -1 -1 -1 -1 -1 -1 -1 -1 -1 -1
179 179 179 179 179 179 179 179 179 179 179 179 179 179 179 179 179 94 85 94 85 94 94 94 94 94 94 94 94 94 94 94 94 85 94 179 179 94 45 94 168 168 116 94 94 153 153 153 94 116 116 229 210 211 212 249 116 116 115 -1 -1 -1 -1 -1 -1 -1 -1 -1 -1 -1 -1 -1 -1 -1 -1 -1 -1 -1 -1 -1
179 179 179 179 179 179 179 179 179 179 179 179 179 179 179 179 179 94 85 94 85 94 48 50 94 45 94 64 66 50 94 48 66 90 94 94 94 94 85 94 168 168 116 94 153 153 153 153 153 116 116 116 116 116 116 116 116 116 115 -1 -1 -1 -1 -1 -1 -1 -1 -1 -1 -1 -1 -1 -1 -1 -1 -1 -1 -1 -1 -1
179 179 179 179 179 179 179 179 179 179 179 179 179 179 179 179 179 94 85 94 88 66 89 90 94 85 94 94 94 85 94 85 94 94 94 65 66 66 90 94 168 168 116 94 153 153 153 153 153 116 116 116 116 116 116 116 116 116 115 -1 -1 -1 -1 -1 -1 -1 -1 -1 -1 -1 -1 -1 -1 -1 -1 -1 -1 -1 -1 -1
179 179 179 179 179 179 179 179 179 179 179 179 179 179 179 179 179 94 85 94 94 94 94 94 94 68 50 94 48 65 66 89 66 66 66 90 94 94 94 94 94 116 116 94 153 153 153 153 153 116 116 94 49 49 49 94 116 116 115 -1 -1 -1 -1 -1 -1 -1 -1 -1 -1 -1 -1 -1 -1 -1 -1 -1 -1 -1 -1 -1
179 179 179 179 179 179 179 179 179 179 179 179 179 179 179 179 179 94 85 94 48 49 50 94 48 65 70 94 68 70 94 94 94 94 94 94 94 48 49 50 94 116 116 94 94 153 153 153 94 116 116 68 69 69 69 70 116 116 115 -1 -1 -1 -1 -1 -1 -1 -1 -1 -1 -1 -1 -1 -1 -1 -1 -1 -1 -1 -1 -1
179 179 179 179 179 179 179 179 179 179 179 179 179 179 179 179 179 94 85 94 68 89 70 94 85 94 85 94 68 70 94 48 49 66 66 66 66 65 94 70 94 116 116 94 94 94 94 94 94 116 116 68 69 69 69 70 116 116 115 -1 -1 -1 -1 -1 -1 -1 -1 -1 -1 -1 -1 -1 -1 -1 -1 -1 -1 -1 -1 -1
179 179 179 179 179 179 179 179 179 179 179 179 179 179 179 179 179 94 105 94 85 94 85 94 85 94 85 94 68 70 94 68 70 94 94 94 94 68 69 70 94 116 116 116 116 116 116 116 94 116 116 68 69 69 69 70 116 116 115 -1 -1 -1 -1 -1 -1 -1 -1 -1 -1 -1 -1 -1 -1 -1 -1 -1 -1 -1 -1 -1
179 179 179 179 179 179 179 179 179 179 179 179 179 179 179 179 179 94 94 94 85 94 88 66 90 94 88 66 89 89 89 89 90 94 167 167 94 88 89 90 94 116 116 116 116 116 116 116 94 116 116 94 89 69 89 94 116 116 115 -1 -1 -1 -1 -1 -1 -1 -1 -1 -1 -1 -1 -1 -1 -1 -1 -1 -1 -1 -1 -1
179 179 179 179 179 179 179 179 179 179 179 179 179 179 179 179 179 179 179 94 85 94 94 94 94 94 94 94 94 94 94 94 94 94 167 167 94 94 94 94 94 116 116 116 116 116 116 116 94 116 116 116 116 69 116 116 116 116 115 -1 -1 -1 -1 -1 -1 -1 -1 -1 -1 -1 -1 -1 -1 -1 -1 -1 -1 -1 -1 -1
179 179 179 179 179 179 179 179 179 179 179 179 179 179 179 179 179 179 179 94 85 94 94 94 94 167 167 167 167 167 94 167 167 167 94 167 167 167 94 94 94 94 94 94 94 94 94 94 94 96 96 96 96 69 96 96 96 96 94 -1 -1 -1 -1 -1 -1 -1 -1 -1 -1 -1 -1 -1 -1 -1 -1 -1 -1 -1 -1 -1
179 179 179 179 179 179 179 179 179 179 179 179 179 179 179 179 179 179 179 94 85 94 48 50 94 167 167 167 167 94 45 94 167 94 45 94 167 94 48 49 49 49 49 49 49 49 201 202 49 69 69 69 69 69 69 200 205 70 94 -1 -1 -1 -1 -1 -1 -1 -1 -1 -1 -1 -1 -1 -1 -1 -1 -1 -1 -1 -1 -1
179 179 179 179 179 179 179 179 179 179 179 179 179 179 179 179 179 179 179 94 85 94 68 70 94 94 94 94 94 48 65 50 94 48 65 50 94 48 69 69 69 69 69 69 69 69 221 222 69 69 69 69 69 69 69 220 225 70 94 -1 -1 -1 -1 -1 -1 -1 -1 -1 -1 -1 -1 -1 -1 -1 -1 -1 -1 -1 -1 -1
179 179 179 179 179 179 179 179 179 179 179 179 179 179 179 179 179 179 179 94 88 66 89 89 66 66 66 66 66 65 65 65 66 65 65 65 66 65 69 69 69 69 69 69 69 69 69 69 69 69 69 204 204 69 69 69 69 70 94 -1 -1 -1 -1 -1 -1 -1 -1 -1 -1 -1 -1 -1 -1 -1 -1 -1 -1 -1 -1 -1
179 179 179 179 179 179 179 179 179 179 179 179 179 179 179 179 179 179 179 94 94 94 94 94 94 94 94 94 94 88 65 90 94 88 65 90 94 88 69 69 69 69 69 69 69 69 69 69 69 69 69 123 124 69 69 69 69 70 94 -1 -1 -1 -1 -1 -1 -1 -1 -1 -1 -1 -1 -1 -1 -1 -1 -1 -1 -1 -1 -1
179 179 179 179 179 179 179 179 179 179 179 179 179 179 179 179 179 179 179 179 179 179 179 179 179 179 179 179 179 94 105 94 179 94 105 94 179 94 88 89 89 89 89 89 89 89 89 89 89 89 89 89 89 89 89 89 89 90 94 -1 -1 -1 -1 -1 -1 -1 -1 -1 -1 -1 -1 -1 -1 -1 -1 -1 -1 -1 -1 -1
179 179 179 179 179 179 179 179 179 179 179 179 179 179 179 179 179 179 179 179 179 179 179 179 179 179 179 179 179 179 94 179 179 179 94 179 179 179 94 94 94 94 94 94 94 94 94 94 94 94 94 94 94 94 94 94 94 94 94 -1 -1 -1 -1 -1 -1 -1 -1 -1 -1 -1 -1 -1 -1 -1 -1 -1 -1 -1 -1 -1
179 179 179 179 179 179 179 179 179 179 179 179 179 179 179 179 179 179 179 179 179 179 179 179 179 179 179 179 179 179 179 179 179 179 179 179 179 179 179 179 179 179 -1 -1 -1 -1 -1 -1 -1 -1 -1 -1 -1 -1 -1 -1 -1 -1 -1 -1 -1 -1 -1 -1 -1 -1 -1 -1 -1 -1 -1 -1 -1 -1 -1 -1 -1 -1 -1 -1
179 179 179 179 179 179 179 179 179 179 179 179 179 179 179 179 179 179 179 179 179 179 179 179 179 179 179 179 179 179 179 179 179 179 179 179 179 179 179 179 179 179 -1 -1 -1 -1 -1 -1 -1 -1 -1 -1 -1 -1 -1 -1 -1 -1 -1 -1 -1 -1 -1 -1 -1 -1 -1 -1 -1 -1 -1 -1 -1 -1 -1 -1 -1 -1 -1 -1
179 179 179 179 179 179 179 179 179 179 179 179 179 179 179 179 179 179 179 179 179 179 179 179 179 179 179 179 179 179 179 179 179 179 179 179 179 179 179 179 179 179 -1 -1 -1 -1 -1 -1 -1 -1 -1 -1 -1 -1 -1 -1 -1 -1 -1 -1 -1 -1 -1 -1 -1 -1 -1 -1 -1 -1 -1 -1 -1 -1 -1 -1 -1 -1 -1 -1
179 179 179 179 179 179 179 179 179 179 179 179 179 179 179 179 179 179 179 179 179 179 179 179 179 179 179 179 179 179 179 179 179 179 179 179 179 179 179 179 179 179 179 -1 -1 -1 -1 -1 -1 -1 -1 -1 -1 -1 -1 -1 -1 -1 -1 -1 -1 -1 -1 -1 -1 -1 -1 -1 -1 -1 -1 -1 -1 -1 -1 -1 -1 -1 -1 -1
179 179 179 179 179 179 179 179 179 179 179 179 179 179 179 179 179 179 179 179 179 179 179 179 179 179 179 179 179 179 179 179 179 179 179 179 179 179 179 179 179 179 179 -1 -1 -1 -1 -1 -1 -1 -1 -1 -1 -1 -1 -1 -1 -1 -1 -1 -1 -1 -1 -1 -1 -1 -1 -1 -1 -1 -1 -1 -1 -1 -1 -1 -1 -1 -1 -1
179 179 179 179 179 179 179 179 179 179 179 179 179 179 179 179 179 179 179 179 179 179 179 179 179 179 179 179 179 179 179 179 179 179 179 179 179 179 179 179 179 -1 -1 -1 -1 -1 -1 -1 -1 -1 -1 -1 -1 -1 -1 -1 -1 -1 -1 -1 -1 -1 -1 -1 -1 -1 -1 -1 -1 -1 -1 -1 -1 -1 -1 -1 -1 -1 -1 -1