-1 -1 -1 -1 -1 -1 -1 -1 -1 -1 -1 -1 -1 116 116 116 116 116 116 116 116 116 116 116 116 116 116 116 116 116 116 116 116 116 116 116 116 116 116 116 116 116 116 116 116 116 116 116 116 116 116 116 116 116 116 116 116 116 116 116 116 -1 -1 -1 -1 -1 -1 -1 -1 -1 -1 -1 -1 -1 -1 -1 -1 -1 -1 -1 -1 -1 -1 -1 -1 -1 -1 -1 -1 -1 -1 -1
-1 -1 -1 -1 -1 -1 -1 -1 -1 -1 -1 -1 -1 116 116 116 116 116 116 116 116 116 116 116 116 116 116 116 116 116 116 116 116 116 116 116 116 116 116 116 116 116 116 116 116 116 116 116 116 116 116 116 116 116 116 116 116 116 116 116 116 116 116 116 -1 -1 -1 -1 -1 -1 -1 -1 -1 -1 -1 -1 -1 -1 -1 -1 -1 -1 -1 -1 -1 -1 -1 -1 -1 -1 -1 -1
-1 -1 -1 -1 -1 -1 -1 -1 -1 -1 -1 -1 -1 116 116 116 116 116 116 116 116 116 116 116 116 116 116 116 116 116 116 116 116 116 116 116 116 116 116 116 116 116 116 116 116 116 116 116 116 116 116 116 116 116 116 116 116 116 116 116 116 116 116 116 -1 -1 -1 -1 -1 -1 -1 -1 -1 -1 -1 -1 -1 -1 -1 -1 -1 -1 -1 -1 -1 -1 -1 -1 -1 -1 -1 -1
-1 -1 -1 -1 -1 -1 -1 -1 -1 -1 -1 -1 -1 116 116 116 116 116 116 116 116 116 116 116 116 116 116 116 116 116 116 116 116 116 116 116 116 116 116 116 116 116 116 116 116 116 116 116 116 116 116 116 116 116 116 116 116 116 116 116 116 116 116 116 116 -1 -1 -1 -1 -1 -1 -1 -1 -1 -1 -1 -1 -1 -1 -1 -1 -1 -1 -1 -1 -1 -1 -1 -1 -1 -1 -1
-1 -1 -1 -1 -1 -1 -1 -1 -1 -1 -1 -1 -1 116 116 116 116 116 116 116 116 116 116 116 116 116 116 116 116 116 116 116 116 116 116 116 116 116 116 116 116 116 116 116 116 116 116 116 116 116 116 116 116 116 116 116 116 116 116 116 116 116 116 116 116 -1 -1 -1 -1 -1 -1 -1 -1 -1 -1 -1 -1 -1 -1 -1 -1 -1 -1 -1 -1 -1 -1 -1 -1 -1 -1 -1
-1 -1 -1 -1 -1 -1 -1 -1 -1 -1 -1 -1 -1 116 116 116 116 116 116 116 116 116 116 116 116 116 116 116 116 116 116 116 116 116 116 116 116 116 116 116 116 116 116 116 116 116 116 116 116 116 116 116 116 116 116 116 116 116 116 116 116 116 116 116 116 -1 -1 -1 -1 -1 -1 -1 -1 -1 -1 -1 -1 -1 -1 -1 -1 -1 -1 -1 -1 -1 -1 -1 -1 -1 -1 -1
-1 -1 -1 -1 -1 -1 -1 -1 -1 -1 -1 -1 -1 116 116 116 116 116 116 116 116 116 116 116 116 116 116 116 116 116 116 116 116 116 116 116 116 116 116 116 116 116 116 116 116 116 116 116 116 116 116 116 116 116 116 116 116 116 116 116 116 116 116 116 116 -1 -1 -1 -1 -1 -1 -1 -1 -1 -1 -1 -1 -1 -1 -1 -1 -1 -1 -1 -1 -1 -1 -1 -1 -1 -1 -1
-1 -1 -1 -1 -1 -1 -1 -1 -1 -1 -1 -1 -1 116 116 116 116 116 116 116 116 116 143 143 143 143 143 143 143 143 143 143 143 143 143 143 143 143 143 143 143 143 116 116 116 116 116 116 116 116 116 116 116 116 116 116 116 116 116 116 116 116 116 116 116 -1 -1 -1 -1 -1 -1 -1 -1 -1 -1 -1 -1 -1 -1 -1 -1 -1 -1 -1 -1 -1 -1 -1 -1 -1 -1 -1
-1 -1 -1 -1 -1 -1 -1 -1 -1 -1 -1 -1 -1 116 116 116 116 116 116 116 116 116 143 48 49 49 49 49 49 49 49 49 49 49 49 49 49 49 49 49 50 143 116 116 116 116 116 116 116 116 116 116 116 116 116 116 116 116 116 116 116 116 116 116 116 116 116 116 116 116 116 116 116 116 -1 -1 -1 -1 -1 -1 -1 -1 -1 -1 -1 -1 -1 -1 -1 -1 -1 -1
-1 -1 -1 -1 -1 -1 -1 -1 -1 -1 -1 -1 -1 116 116 116 116 116 116 116 116 116 143 68 69 69 69 69 11 16 12 69 69 69 69 69 69 200 201 205 70 143 116 116 116 116 116 116 116 116 116 116 116 116 116 116 116 116 116 116 116 116 116 116 116 116 116 116 116 116 116 116 116 116 -1 -1 -1 -1 -1 -1 -1 -1 -1 -1 -1 -1 -1 -1 -1 -1 -1 -1
-1 -1 -1 -1 -1 -1 -1 -1 -1 -1 -1 -1 -1 116 116 116 116 116 116 116 116 116 143 68 69 69 51 52 120 122 124 53 69 69 69 69 69 220 221 224 70 143 116 116 116 116 116 116 116 116 116 116 116 116 94 116 116 116 116 116 116 116 116 116 116 116 116 116 116 116 116 116 116 116 -1 -1 -1 -1 -1 -1 -1 -1 -1 -1 -1 -1 -1 -1 -1 -1 -1 -1
-1 -1 -1 -1 -1 -1 -1 -1 -1 -1 -1 -1 -1 116 116 116 116 116 116 116 116 116 143 68 69 69 91 92 92 92 92 93 69 69 69 69 69 45 69 69 70 143 116 116 116 116 116 116 116 116 116 94 116 116 116 116 116 94 116 116 116 116 116 116 116 116 116 116 116 116 116 116 116 116 -1 -1 -1 -1 -1 -1 -1 -1 -1 -1 -1 -1 -1 -1 -1 -1 -1 -1
-1 -1 -1 -1 -1 -1 -1 -1 -1 -1 -1 -1 -1 116 116 116 116 116 116 116 116 116 143 68 69 69 120 121 122 122 123 124 69 69 69 69 69 85 69 69 70 143 145 116 116 116 116 116 116 116 116 116 116 200 204 205 116 116 116 116 116 116 116 116 116 116 116 116 116 116 116 116 116 116 -1 -1 -1 -1 -1 -1 -1 -1 -1 -1 -1 -1 -1 -1 -1 -1 -1 -1
-1 -1 -1 -1 -1 -1 -1 -1 -1 -1 -1 -1 -1 116 116 116 116 116 116 116 116 116 143 68 69 69 200 201 202 203 204 205 69 69 69 69 69 85 69 69 70 143 116 116 4 116 116 116 116 94 116 116 94 24 24 24 94 116 116 94 116 116 116 116 116 116 116 116 116 116 116 116 116 116 -1 -1 -1 -1 -1 -1 -1 -1 -1 -1 -1 -1 -1 -1 -1 -1 -1 -1
-1 -1 -1 -1 -1 -1 -1 -1 -1 -1 -1 -1 -1 116 116 116 116 116 116 116 116 116 143 68 69 69 220 221 222 223 224 225 69 69 69 69 69 85 69 69 70 104 142 144 24 144 144 116 116 116 116 116 109 48 49 50 108 116 116 116 116 116 116 116 116 116 116 116 116 116 116 116 116 116 -1 -1 -1 -1 -1 -1 -1 -1 -1 -1 -1 -1 -1 -1 -1 -1 -1 -1
-1 -1 -1 -1 -1 -1 -1 -1 -1 -1 -1 -1 -1 116 116 116 116 116 116 116 116 116 143 68 69 69 69 69 69 45 69 69 69 69 69 69 69 85 69 69 69 49 49 49 49 50 144 116 116 116 116 94 109 68 125 70 108 94 116 116 116 116 116 116 116 116 116 116 116 116 116 116 116 116 116 116 116 116 116 116 116 116 116 116 116 116 116 116 116 116 -1 -1
-1 -1 -1 -1 -1 -1 -1 -1 -1 -1 -1 -1 -1 116 116 116 116 116 116 116 116 116 143 68 69 69 45 69 69 85 69 69 69 69 69 69 69 85 69 69 69 69 69 69 69 8 144 116 116 116 116 116 109 68 65 70 108 116 116 116 116 116 116 116 116 116 116 116 116 116 116 116 116 116 116 116 116 116 116 116 116 116 116 116 116 116 116 116 116 116 116 116
-1 -1 -1 -1 -1 -1 -1 -1 -1 -1 -1 -1 -1 116 116 116 116 116 116 116 116 116 143 68 69 64 65 66 66 65 66 66 66 66 66 66 66 65 67 69 69 69 69 84 69 8 144 116 116 94 116 116 94 68 125 70 94 116 116 94 116 116 116 116 116 116 116 116 116 116 116 116 116 116 116 116 116 116 116 116 116 116 116 116 116 116 116 116 116 116 116 116
-1 -1 -1 -1 -1 -1 -1 -1 -1 -1 -1 -1 -1 116 116 116 116 116 116 116 116 116 143 68 69 69 85 69 69 105 69 69 69 69 69 69 69 85 69 69 84 200 202 205 69 8 144 116 116 116 116 116 113 68 65 70 108 116 116 116 116 116 116 116 116 116 116 116 116 116 116 116 116 116 116 116 116 116 116 116 116 116 116 116 116 116 116 116 116 116 116 116
-1 -1 -1 -1 -1 -1 -1 -1 -1 -1 -1 -1 -1 116 116 116 116 116 116 116 116 116 143 88 89 89 85 89 89 89 89 89 89 89 46 69 84 85 69 69 69 120 123 124 69 8 144 116 116 116 116 94 109 68 125 70 108 94 116 116 116 116 116 116 116 116 116 116 116 116 116 116 116 116 116 116 116 116 116 116 116 116 116 116 116 116 116 116 116 116 116 116
179 179 179 179 179 179 179 179 179 179 179 179 179 116 116 116 116 116 116 116 116 116 143 143 142 143 85 143 143 142 143 143 143 144 68 69 200 203 205 69 69 69 45 84 69 8 144 116 116 116 116 116 109 68 65 70 108 116 116 116 116 116 116 116 116 116 116 116 116 116 116 116 116 116 116 116 116 116 116 116 116 116 116 116 116 116 116 116 116 116 116 116
179 179 179 179 179 179 179 179 179 179 179 179 179 179 179 179 179 179 179 179 179 179 179 179 179 143 85 144 179 179 179 179 179 144 68 51 121 122 124 12 66 66 65 69 69 8 144 116 116 94 116 116 94 68 125 70 94 116 116 94 116 116 116 116 116 116 116 116 116 116 116 116 116 116 116 116 116 116 116 116 116 116 116 116 116 116 116 116 116 116 116 116
179 179 179 179 179 179 179 179 179 179 179 179 179 179 179 179 179 179 179 179 179 179 179 179 179 144 85 144 179 179 179 179 179 144 68 91 92 92 92 93 69 69 85 69 69 8 144 116 116 116 116 116 109 68 65 70 108 116 116 116 116 116 116 116 116 116 116 116 116 116 116 116 116 116 116 116 116 116 116 116 116 116 116 116 116 116 116 116 116 116 116 116
179 179 179 179 179 179 179 179 179 179 179 179 179 179 179 179 179 179 179 179 179 179 179 179 144 144 85 144 144 179 179 179 179 144 68 200 201 201 201 205 69 69 85 69 69 8 144 116 116 116 116 94 109 68 125 70 108 94 116 116 116 116 116 116 116 116 116 116 116 116 116 116 116 116 116 116 116 116 116 116 116 116 116 116 116 116 116 116 116 116 116 116
179 179 179 179 179 179 179 179 179 179 179 179 179 179 179 179 179 179 179 179 179 179 179 179 144 48 65 50 144 179 179 179 179 144 68 220 221 222 223 224 69 69 85 69 47 8 142 141 141 141 142 141 143 68 65 70 108 116 116 116 116 116 116 116 116 116 116 116 116 116 116 116 116 116 116 116 116 116 116 116 116 116 116 116 116 116 116 116 116 116 116 116
179 179 179 179 179 179 179 179 179 179 179 179 179 179 179 179 179 179 179 179 179 179 179 179 144 68 65 70 144 179 179 179 179 144 68 47 69 69 64 66 66 66 65 66 66 66 66 66 66 66 66 66 66 84 125 70 94 116 116 116 116 116 116 116 116 116 116 116 116 116 116 116 116 116 116 116 116 116 116 116 116 116 116 116 116 116 116 116 116 116 116 116
179 179 179 179 179 179 179 179 179 179 179 179 179 179 179 179 179 179 179 179 179 179 179 179 144 88 65 142 144 179 179 179 179 144 88 89 89 89 89 89 89 89 85 89 89 90 143 104 104 104 104 104 104 101 100 100 108 116 116 116 116 116 116 116 116 116 116 116 116 116 116 116 116 116 116 230 231 232 204 204 205 116 116 116 116 116 116 116 116 116 116 116
179 179 179 179 179 179 179 179 179 179 179 179 179 179 179 179 179 179 179 179 179 179 179 179 144 144 85 144 144 179 179 179 179 144 144 144 144 144 144 143 143 143 144 143 143 143 143 179 179 179 179 179 179 94 116 116 135 94 136 136 136 136 136 136 136 136 136 136 156 156 156 156 156 116 116 170 171 172 182 183 184 116 116 116 116 116 116 116 116 116 116 116
179 179 179 179 179 179 179 179 179 179 179 179 179 179 94 94 94 94 94 94 94 94 94 94 94 94 85 94 94 94 94 179 179 179 179 179 179 179 179 179 179 179 179 179 179 179 179 179 179 179 179 179 179 94 116 116 116 116 116 116 116 116 116 116 116 116 116 116 116 116 116 116 116 116 116 190 191 192 24 204 204 116 116 116 116 116 116 116 116 116 116 116
179 179 179 179 179 179 179 179 179 179 179 179 179 179 94 48 66 66 66 50 94 94 94 94 94 94 85 94 94 94 94 179 179 179 179 179 179 179 179 179 179 179 179 179 179 179 179 179 150 151 152 179 179 94 116 116 116 116 116 116 116 116 116 116 177 178 179 173 174 175 176 177 178 179 116 210 211 212 61 62 63 116 116 116 116 116 116 116 116 116 116 116
179 179 179 179 179 179 179 179 179 179 179 179 179 94 94 85 94 94 94 85 94 48 66 50 94 94 85 94 94 94 94 179 179 179 179 179 179 179 179 179 179 179 179 179 179 179 179 179 170 171 172 179 179 94 116 116 116 116 116 116 116 116 116 116 197 198 199 193 194 195 196 197 198 199 203 230 231 232 81 82 83 116 116 116 116 116 116 116 116 116 116 116
179 179 179 179 179 179 179 179 179 179 179 179 179 94 48 65 49 67 94 88 66 90 94 88 66 66 65 66 66 50 94 179 179 94 94 94 179 179 179 94 94 94 94 94 94 94 94 94 190 191 192 94 94 94 94 116 116 116 116 116 116 116 116 116 217 218 219 213 214 215 216 217 218 219 24 250 123 124 101 102 103 116 116 116 116 116 116 116 116 116 116 116
179 179 179 179 179 179 179 179 179 179 179 179 179 94 85 94 85 94 94 94 94 94 94 94 94 94 94 94 94 85 94 179 179 94 45 94 179 179 179 94 94 202 203 204 94 116 116 229 210 211 212 249 116 116 94 116 116 116 200 203 204 205 116 116 186 187 188 95 96 96 97 200 201 202 203 177 178 179 200 205 116 116 116 116 116 116 116 116 116 116 116 116
179 179 179 179 179 179 179 179 179 179 179 179 179 94 85 94 85 94 48 50 94 45 94 64 66 50 94 48 66 90 94 94 94 94 85 94 179 179 179 94 153 222 223 224 153 116 116 116 116 116 116 116 116 116 94 116 116 116 101 102 103 104 116 116 206 207 208 115 116 116 117 220 221 222 223 197 198 199 223 225 116 116 116 116 116 116 116 116 116 116 116 116
179 179 179 179 179 179 179 179 179 179 179 179 179 94 85 94 88 66 89 90 94 85 94 94 94 85 94 85 94 94 94 65 66 66 90 94 179 179 179 94 153 153 153 153 153 116 116 116 116 45 116 116 116 116 94 201 202 116 116 116 116 116 116 116 226 227 228 135 136 136 116 97 200 203 205 217 218 219 230 231 232 116 116 116 116 116 116 116 116 116 116 116
179 179 179 179 179 179 179 179 179 179 179 179 179 94 85 94 94 94 94 94 94 68 50 94 48 65 66 89 66 66 66 90 94 94 94 94 94 179 179 94 153 153 153 153 153 116 116 94 49 65 49 94 116 116 94 221 222 94 94 142 143 144 94 116 246 247 200 202 202 205 115 117 74 75 76 186 187 188 210 211 212 116 116 116 116 116 116 116 116 116 116 116
179 179 179 179 179 179 179 179 179 179 179 179 179 94 85 94 48 49 50 94 48 65 70 94 68 70 94 94 94 94 94 94 94 48 49 50 94 179 179 94 94 153 153 153 94 116 116 68 69 69 69 70 116 116 153 153 153 153 153 153 153 153 94 203 204 167 101 102 103 104 115 117 200 204 205 206 207 208 -1 200 203 205 116 116 116 116 116 116 116 116 116 116
179 179 179 179 179 179 179 179 179 179 179 179 179 94 85 94 68 89 70 94 85 94 85 94 68 70 94 48 49 66 66 66 66 65 94 70 94 179 179 94 94 94 94 94 94 116 64 65 69 44 69 65 67 116 156 156 156 156 156 155 153 153 94 223 224 187 188 66 67 116 116 117 220 224 225 226 227 228 148 120 121 124 116 116 116 116 116 116 116 116 116 116
179 179 179 179 179 179 179 179 179 179 179 179 179 94 105 94 85 94 85 94 85 94 85 94 68 70 94 68 70 94 94 94 94 68 69 70 94 179 179 179 179 179 179 179 94 116 116 68 69 69 69 70 116 116 94 94 94 94 94 94 153 153 94 116 206 207 208 116 116 106 107 112 86 87 115 246 247 248 109 200 204 200 205 116 116 116 116 116 116 116 116 116
179 179 179 179 179 179 179 179 179 179 179 179 179 94 94 94 85 94 88 66 90 94 88 66 89 89 89 89 90 94 167 167 94 88 89 90 94 179 179 179 179 179 179 179 94 116 116 94 89 65 89 94 116 116 94 179 179 179 94 94 44 44 94 94 226 227 228 116 116 126 127 117 204 205 147 166 167 168 148 11 12 24 24 116 116 116 116 116 116 116 116 116
179 179 179 179 179 179 179 179 179 179 179 179 179 179 179 94 85 94 94 94 94 94 94 94 94 94 94 94 94 94 167 167 94 94 94 94 94 179 179 179 179 179 179 179 94 116 116 116 116 69 116 116 116 116 94 179 179 179 94 217 217 217 217 94 246 247 203 136 136 136 125 117 224 225 115 186 187 188 51 210 211 122 124 53 116 116 116 116 116 116 116 116
179 179 179 179 179 179 179 179 179 179 179 179 179 179 179 94 85 94 94 94 94 167 167 167 167 167 94 167 167 167 94 167 167 167 94 94 94 94 94 94 94 94 94 94 94 96 96 96 96 69 96 96 96 96 94 179 179 179 94 237 217 198 168 94 203 204 24 200 203 205 135 137 184 185 147 206 207 208 91 92 92 92 92 93 116 116 116 116 116 116 116 116
179 179 179 179 179 179 179 179 179 179 179 179 179 179 179 94 85 94 48 50 94 167 167 167 167 94 45 94 167 94 45 94 167 94 48 49 49 49 49 49 49 49 201 202 49 69 69 69 69 69 69 200 205 70 94 179 179 179 94 217 217 217 188 94 223 224 183 210 211 212 203 204 205 205 147 226 227 228 200 201 202 203 204 205 116 116 116 116 116 116 116 116
179 179 179 179 179 179 179 179 179 179 179 179 179 179 179 94 85 94 68 70 94 94 94 94 94 48 65 50 94 48 65 50 94 48 69 69 69 69 69 69 69 69 221 222 69 69 69 69 69 69 69 220 225 70 94 179 179 179 94 186 179 179 188 94 144 144 144 230 231 232 223 224 182 142 104 246 247 248 220 221 222 223 224 200 201 116 116 116 116 116 116 116
179 179 179 179 179 179 179 179 179 179 179 179 179 179 179 94 88 66 89 89 66 66 66 66 66 65 65 65 66 65 65 65 66 65 69 69 69 69 69 69 69 69 69 69 69 69 69 204 204 69 69 69 69 70 94 179 179 179 94 217 217 217 217 173 174 175 176 177 179 179 179 173 174 175 176 177 178 179 173 174 175 176 177 220 221 116 116 116 116 116 116 116
179 179 179 179 179 179 179 179 179 179 179 179 179 179 179 94 94 94 94 94 94 94 94 94 94 88 65 90 94 88 65 90 94 88 69 69 69 69 69 69 69 69 69 69 69 69 69 123 124 69 69 69 69 70 94 179 179 179 94 186 193 193 193 193 194 195 196 197 177 198 179 193 194 195 196 197 198 199 193 194 195 196 197 217 217 141 143 144 200 201 202 203
179 179 179 179 179 179 179 179 179 179 179 179 179 179 179 179 179 179 179 179 179 179 179 179 179 94 105 94 179 94 105 94 179 94 88 89 89 89 89 89 89 89 89 89 89 89 89 89 89 89 89 89 89 90 94 179 179 179 94 246 213 213 213 213 214 215 216 217 179 179 239 213 214 215 216 217 218 219 213 214 215 217 200 203 204 205 217 217 181 182 183 184
179 179 179 179 179 179 179 179 179 179 179 179 179 179 179 179 179 179 179 179 179 179 179 179 179 179 94 179 179 179 94 179 179 179 94 94 94 94 94 94 94 94 94 94 94 94 94 94 94 94 94 94 94 94 94 179 179 179 94 144 144 144 144 144 144 144 144 144 144 144 144 144 144 144 144 144 141 142 143 144 141 141 120 122 123 124 142 143 167 167 167 167
179 179 179 179 179 179 179 179 179 179 179 179 179 179 179 179 179 179 179 179 179 179 179 179 179 179 179 179 179 179 179 179 179 179 179 179 179 179 179 179 179 179 179 179 179 179 179 179 179 179 179 179 179 179 179 179 179 179 179 179 179 179 179 179 179 179 179 179 179 179 179 179 167 167 167 167 167 167 167 167 167 167 167 167 167 167 167 167 167 167 167 167
179 179 179 179 179 179 179 179 179 179 179 179 179 179 179 179 179 179 179 179 179 179 179 179 179 179 179 179 179 179 179 179 179 179 179 179 179 179 179 179 179 179 179 179 179 179 179 179 179 179 179 179 179 179 179 179 179 179 179 179 179 179 179 179 179 179 179 179 179 179 179 179 217 217 217 217 217 217 217 217 217 217 217 217 217 217 217 217 167 167 167 167
179 179 179 179 179 179 179 179 179 179 179 179 179 179 179 179 179 179 179 179 179 179 179 179 179 179 179 179 179 179 179 179 179 179 179 179 179 179 179 179 179 179 179 179 179 179 179 179 179 179 179 179 179 179 179 179 179 179 179 179 179 179 179 179 179 179 179 179 179 179 179 179 217 217 217 217 217 217 217 217 217 217 217 217 217 217 217 217 167 167 167 167
179 179 179 179 179 179 179 179 179 179 179 179 179 179 179 179 179 179 179 179 179 179 179 179 179 179 179 179 179 179 179 179 179 179 179 179 179 179 179 179 179 179 179 179 179 179 179 179 179 179 179 179 179 179 179 179 179 179 179 179 179 179 179 179 179 179 179 179 179 179 179 179 217 217 217 217 217 217 217 217 217 217 217 217 217 217 217 217 167 167 167 167
179 179 179 179 179 179 179 179 179 179 179 179 179 179 179 179 179 179 179 179 179 179 179 179 179 179 179 179 179 179 179 179 179 179 179 179 179 179 179 179 179 179 179 179 179 179 179 179 179 179 179 179 179 179 179 179 179 179 179 179 179 179 179 179 179 179 179 179 179 179 179 179 217 217 217 217 217 217 217 217 217 217 217 217 217 217 217 217 167 167 167 167
179 179 179 179 179 179 179 179 179 179 179 179 179 179 179 179 179 179 179 179 179 179 179 179 179 179 179 179 179 179 179 179 179 179 179 179 179 179 179 179 179 179 179 179 179 179 179 179 179 179 179 179 179 179 179 179 179 179 179 179 179 179 179 179 179 179 179 179 179 179 179 179 217 217 217 217 217 217 217 217 217 217 217 217 217 217 217 217 167 167 167 167